"aa" = (/turf/space,/area/space)
"ab" = (/turf/wall/r_wall/prepainted,/area/space)
"ac" = (/obj/machinery/door/airlock/maintenance{name = "Drone Fabrication/Engine Waste Handling"},/obj/structure/cable{icon_state = "1-2"},/obj/machinery/atmospherics/pipe/simple/hidden/scrubbers,/obj/machinery/atmospherics/pipe/simple/hidden/supply,/turf/floor/tiled/techfloor/grid,/area/space)
"ad" = (/obj/machinery/door/airlock/hatch{id_tag = "engine_electrical_maintenance"; locked = 1; name = "Electrical Maintenance"},/obj/structure/cable/yellow{icon_state = "1-2"},/turf/floor/plating,/area/space)
"ae" = (/obj/machinery/door/blast/regular/open{dir = 2; id_tag = "EngineBlast"; name = "EngineBlast"},/obj/effect/wallframe_spawn/reinforced,/turf/floor/plating,/area/space)
"af" = (/obj/machinery/door/blast/regular/open{id_tag = "EngineBlast"; name = "Engine Monitoring Room Blast Doors"},/obj/machinery/atmospherics/pipe/simple/hidden/supply,/obj/machinery/atmospherics/pipe/simple/hidden/scrubbers,/obj/effect/wallframe_spawn/reinforced,/turf/floor/plating,/area/space)
"ag" = (/obj/machinery/door/airlock/hatch/maintenance{id_tag = "engine_airlock_interior"; name = "Engine Airlock Interior"},/turf/floor/plating,/area/space)
"ah" = (/obj/machinery/atmospherics/pipe/simple/visible/black{dir = 4},/turf/wall/r_wall/prepainted,/area/space)
"ai" = (/obj/machinery/atmospherics/pipe/simple/visible/black{dir = 10},/turf/floor/plating,/area/space)
"aj" = (/obj/machinery/atmospherics/unary/vent_scrubber/on{dir = 4},/obj/machinery/light/small{dir = 1},/turf/floor/plating,/area/space)
"ak" = (/obj/machinery/power/apc{dir = 1; name = "north bump"; pixel_y = 24},/obj/structure/cable{icon_state = "0-4"},/obj/machinery/atmospherics/pipe/simple/hidden/scrubbers{dir = 4},/turf/floor/plating,/area/space)
"al" = (/obj/structure/cable{icon_state = "2-4"},/obj/structure/cable{icon_state = "4-8"},/obj/machinery/atmospherics/pipe/simple/hidden/scrubbers{dir = 4},/obj/machinery/atmospherics/pipe/simple/hidden/supply{dir = 6},/obj/machinery/camera/network/engine{c_tag = "Engine Waste Handling"},/obj/effect/floor_decal/industrial/warning/corner,/turf/floor/plating,/area/space)
"am" = (/obj/machinery/light/small{dir = 4},/obj/structure/cable{icon_state = "1-8"},/obj/machinery/atmospherics/pipe/simple/hidden/scrubbers{dir = 9},/obj/machinery/atmospherics/pipe/simple/hidden/supply{dir = 9},/obj/effect/floor_decal/industrial/warning,/obj/structure/sign/warning/radioactive{dir = 8; pixel_x = 32},/turf/floor/plating,/area/space)
"an" = (/obj/machinery/button/blast_door{desc = "A remote control-switch for the engine control room blast doors."; id_tag = "EngineEmitterPortWest"; name = "Engine Room Blast Doors"; pixel_y = 25},/obj/machinery/atmospherics/portables_connector{dir = 4},/obj/effect/floor_decal/industrial/outline/yellow,/obj/effect/engine_setup/empty_canister,/obj/structure/sign/warning/radioactive{dir = 4; pixel_x = -32},/turf/floor/plating,/area/space)
"ao" = (/obj/machinery/light{dir = 1},/obj/machinery/atmospherics/binary/pump{dir = 8},/turf/floor/plating,/area/space)
"ap" = (/obj/machinery/atmospherics/pipe/simple/visible/cyan{dir = 10},/obj/machinery/alarm/nobreach{pixel_y = 22},/obj/effect/floor_decal/industrial/warning{dir = 4},/turf/floor/plating,/area/space)
"aq" = (/obj/machinery/power/terminal{dir = 4},/obj/structure/cable/yellow,/obj/machinery/power/sensor{id_tag = "Engine Output"; name = "Powernet Sensor - Engine Output"},/obj/structure/cable/yellow{icon_state = "0-2"},/obj/effect/floor_decal/industrial/warning{dir = 1},/turf/floor/plating,/area/space)
"ar" = (/obj/structure/cable/yellow{icon_state = "0-4"},/obj/machinery/power/smes/buildable{RCon_tag = "Engine - Core"; charge = 5e+006; input_attempt = 1; input_level = 250000; inputting = 1; output_attempt = 1; output_level = 250000},/obj/effect/floor_decal/industrial/warning{dir = 1},/obj/effect/engine_setup/smes,/turf/floor/plating,/area/space)
"as" = (/obj/structure/cable/cyan{icon_state = "4-8"},/obj/effect/floor_decal/industrial/warning{dir = 8},/turf/floor/plating,/area/space)
"at" = (/obj/structure/cable/cyan{icon_state = "4-8"},/obj/machinery/atmospherics/unary/vent_pump/on{dir = 4},/turf/floor/plating,/area/space)
"au" = (/obj/structure/cable/cyan{icon_state = "4-8"},/obj/machinery/atmospherics/pipe/simple/hidden/supply{dir = 9},/obj/machinery/atmospherics/pipe/simple/hidden/scrubbers{dir = 5},/turf/floor/plating,/area/space)
"av" = (/obj/structure/cable/cyan{icon_state = "4-8"},/obj/machinery/atmospherics/unary/vent_scrubber/on{dir = 8},/turf/floor/plating,/area/space)
"aw" = (/obj/structure/cable/cyan{icon_state = "4-8"},/turf/floor/plating,/area/space)
"ax" = (/obj/machinery/light_switch{pixel_x = 12; pixel_y = 25},/obj/structure/cable/cyan{icon_state = "0-8"},/obj/machinery/power/sensor{id_tag = "Engine Power"; name = "Powernet Sensor - Engine Power"},/obj/machinery/power/apc/super/critical{dir = 1; name = "north bump"; pixel_y = 24},/turf/floor/plating,/area/space)
"ay" = (/obj/machinery/atmospherics/portables_connector,/obj/effect/floor_decal/industrial/outline/blue,/obj/effect/engine_setup/coolant_canister,/turf/floor/plating,/area/space)
"az" = (/turf/floor/plating,/area/space)
"aA" = (/obj/machinery/airlock_sensor{id_tag = "engine_room_airlock"; pixel_y = 22},/obj/machinery/light{dir = 1},/turf/floor/plating,/area/space)
"aB" = (/obj/machinery/atmospherics/pipe/simple/heat_exchanging{dir = 6},/turf/space,/area/space)
"aC" = (/obj/machinery/atmospherics/pipe/simple/heat_exchanging{dir = 10},/turf/space,/area/space)
"aD" = (/obj/structure/lattice,/obj/machinery/atmospherics/pipe/simple/heat_exchanging{dir = 10},/turf/space,/area/space)
"aE" = (/obj/machinery/atmospherics/pipe/manifold4w/visible/black,/turf/floor/plating,/area/space)
"aF" = (/obj/machinery/atmospherics/binary/pump{dir = 8},/obj/effect/engine_setup/pump_max,/turf/floor/plating,/area/space)
"aG" = (/obj/machinery/atmospherics/portables_connector{dir = 8},/obj/effect/floor_decal/industrial/outline/yellow,/obj/effect/engine_setup/coolant_canister,/turf/floor/plating,/area/space)
"aH" = (/obj/structure/cable{icon_state = "1-2"},/obj/effect/floor_decal/industrial/warning{dir = 4},/obj/machinery/atmospherics/pipe/simple/hidden/supply,/turf/floor/plating,/area/space)
"aI" = (/obj/structure/window/reinforced{dir = 1},/obj/machinery/atmospherics/portables_connector,/obj/machinery/door/window/brigdoor/westleft{name = "Engine Waste"},/obj/effect/floor_decal/industrial/outline/yellow,/obj/effect/engine_setup/empty_canister,/turf/floor/plating,/area/space)
"aJ" = (/obj/machinery/door/blast/regular{dir = 8; id_tag = "EngineEmitterPortWest"; name = "Engine Waste Handling Access"},/turf/floor/plating,/area/space)
"aK" = (/obj/machinery/atmospherics/pipe/simple/visible/black{dir = 6},/obj/effect/floor_decal/industrial/warning{dir = 8},/turf/floor/plating,/area/space)
"aL" = (/obj/machinery/atmospherics/omni/filter{tag_east = 1; tag_south = 4; tag_west = 2; use_power = 0},/obj/effect/engine_setup/filter,/turf/floor/plating,/area/space)
"aM" = (/obj/machinery/atmospherics/pipe/manifold/visible/cyan{dir = 4},/obj/effect/floor_decal/industrial/warning/corner{dir = 4},/turf/floor/plating,/area/space)
"aN" = (/obj/structure/cable/yellow{icon_state = "1-4"},/obj/effect/floor_decal/industrial/warning{dir = 1},/turf/floor/plating,/area/space)
"aO" = (/obj/structure/cable/yellow{icon_state = "4-8"},/obj/effect/floor_decal/industrial/warning{dir = 1},/turf/floor/plating,/area/space)
"aP" = (/obj/structure/cable/yellow{icon_state = "4-8"},/obj/effect/floor_decal/industrial/warning/corner{dir = 1},/turf/floor/plating,/area/space)
"aQ" = (/obj/structure/cable/yellow{icon_state = "4-8"},/turf/floor/plating,/area/space)
"aR" = (/obj/machinery/atmospherics/binary/pump,/obj/structure/cable/yellow{icon_state = "4-8"},/obj/effect/engine_setup/pump_max,/turf/floor/plating,/area/space)
"aS" = (/obj/structure/cable/yellow{icon_state = "2-8"},/turf/floor/plating,/area/space)
"aT" = (/obj/machinery/atmospherics/binary/pump,/obj/effect/engine_setup/pump_max,/turf/floor/plating,/area/space)
"aU" = (/obj/structure/lattice,/obj/machinery/atmospherics/pipe/simple/heat_exchanging,/turf/space,/area/space)
"aV" = (/obj/machinery/atmospherics/pipe/simple/heat_exchanging,/turf/space,/area/space)
"aW" = (/obj/machinery/atmospherics/unary/heat_exchanger{dir = 8},/obj/effect/floor_decal/industrial/warning{dir = 9},/turf/floor/plating,/area/space)
"aX" = (/obj/machinery/atmospherics/unary/heat_exchanger{dir = 4},/obj/effect/floor_decal/industrial/warning{dir = 5},/turf/floor/plating,/area/space)
"aY" = (/obj/structure/cable{icon_state = "1-2"},/obj/machinery/atmospherics/pipe/manifold/visible/black{dir = 1},/obj/effect/floor_decal/industrial/warning{dir = 4},/obj/machinery/atmospherics/pipe/simple/hidden/supply,/turf/floor/plating,/area/space)
"aZ" = (/obj/machinery/atmospherics/pipe/simple/visible/black{dir = 9},/obj/machinery/door/window/brigdoor/westleft{name = "Engine Waste"},/obj/effect/floor_decal/industrial/outline/yellow,/turf/floor/plating,/area/space)
"ba" = (/obj/machinery/door/blast/regular{dir = 4; id_tag = "EngineEmitterPortWest"; name = "Engine Waste Handling Access"},/turf/floor/plating,/area/space)
"bb" = (/obj/machinery/atmospherics/pipe/simple/visible/black,/obj/effect/floor_decal/industrial/warning{dir = 8},/turf/floor/plating,/area/space)
"bc" = (/obj/machinery/atmospherics/pipe/manifold/visible/cyan{dir = 8},/turf/floor/plating,/area/space)
"bd" = (/obj/machinery/meter,/obj/machinery/atmospherics/pipe/manifold/visible/cyan{dir = 4},/turf/floor/plating,/area/space)
"be" = (/obj/machinery/atmospherics/pipe/simple/visible/cyan{dir = 6},/turf/floor/plating,/area/space)
"bf" = (/obj/machinery/atmospherics/pipe/simple/visible/cyan{dir = 4},/turf/floor/plating,/area/space)
"bg" = (/obj/machinery/atmospherics/pipe/simple/visible/cyan{dir = 10},/turf/floor/plating,/area/space)
"bh" = (/obj/machinery/atmospherics/valve/digital{dir = 4; name = "Emergency Cooling Valve 1"},/turf/floor/plating,/area/space)
"bi" = (/obj/structure/cable/yellow{icon_state = "1-2"},/obj/machinery/atmospherics/pipe/manifold/visible/green{dir = 1},/turf/floor/plating,/area/space)
"bj" = (/obj/machinery/atmospherics/pipe/manifold/visible/green{dir = 4},/turf/floor/plating,/area/space)
"bk" = (/obj/machinery/atmospherics/pipe/manifold/visible/black,/obj/machinery/meter,/turf/floor/plating,/area/space)
"bl" = (/obj/machinery/atmospherics/unary/heat_exchanger{dir = 8},/obj/effect/floor_decal/industrial/warning{dir = 10},/turf/floor/plating,/area/space)
"bm" = (/obj/machinery/atmospherics/unary/heat_exchanger{dir = 4},/obj/effect/floor_decal/industrial/warning{dir = 6},/turf/floor/plating,/area/space)
"bn" = (/obj/structure/cable{icon_state = "1-2"},/obj/machinery/atmospherics/pipe/manifold/visible/black,/obj/machinery/meter{id_tag = "wloop_atm_meter"},/obj/effect/floor_decal/industrial/warning{dir = 4},/obj/machinery/atmospherics/pipe/simple/hidden/supply,/turf/floor/plating,/area/space)
"bo" = (/obj/structure/window/reinforced,/obj/machinery/atmospherics/binary/pump{dir = 8; name = "waste pump"},/obj/machinery/door/window/brigdoor/westleft{name = "Engine Waste"},/obj/effect/floor_decal/industrial/outline/yellow,/obj/effect/engine_setup/pump_max,/turf/floor/plating,/area/space)
"bp" = (/obj/machinery/door/blast/regular{dir = 4; id_tag = "EngineEmitterPortWest"; name = "Engine Waste Handling Access"},/obj/machinery/atmospherics/pipe/simple/visible/black{dir = 4},/turf/floor/plating,/area/space)
"bq" = (/obj/machinery/atmospherics/pipe/manifold/visible/black,/obj/effect/floor_decal/industrial/warning{dir = 8},/turf/floor/plating,/area/space)
"br" = (/obj/machinery/atmospherics/omni/filter{tag_east = 1; tag_north = 4; tag_west = 2; use_power = 0},/obj/effect/engine_setup/filter,/turf/floor/plating,/area/space)
"bs" = (/obj/machinery/atmospherics/pipe/manifold/visible/cyan,/turf/floor/plating,/area/space)
"bt" = (/obj/machinery/light{dir = 8},/obj/machinery/fuel_compressor,/turf/floor/plating,/area/space)
"bu" = (/obj/machinery/atmospherics/pipe/simple/visible/cyan{dir = 9},/turf/floor/plating,/area/space)
"bv" = (/obj/machinery/atmospherics/pipe/simple/visible/cyan{dir = 5},/turf/floor/plating,/area/space)
"bw" = (/obj/machinery/meter,/obj/machinery/atmospherics/pipe/manifold4w/visible/cyan,/obj/effect/floor_decal/industrial/warning/corner,/turf/floor/plating,/area/space)
"bx" = (/obj/machinery/atmospherics/pipe/simple/visible/cyan{dir = 10},/obj/effect/floor_decal/industrial/warning,/turf/floor/plating,/area/space)
"by" = (/obj/structure/cable/yellow{icon_state = "1-2"},/obj/effect/floor_decal/industrial/warning,/obj/machinery/atmospherics/pipe/simple/visible/green,/turf/floor/plating,/area/space)
"bz" = (/obj/machinery/atmospherics/pipe/manifold/visible/green{dir = 8},/obj/effect/floor_decal/industrial/warning,/obj/machinery/meter,/turf/floor/plating,/area/space)
"bA" = (/obj/effect/floor_decal/industrial/warning/corner{dir = 8},/obj/machinery/atmospherics/binary/pump/high_power{dir = 8},/obj/effect/engine_setup/pump_max,/turf/floor/plating,/area/space)
"bB" = (/obj/effect/floor_decal/industrial/warning{dir = 4},/obj/machinery/atmospherics/pipe/manifold/visible/black{dir = 1},/turf/floor/plating,/area/space)
"bC" = (/obj/structure/lattice,/obj/machinery/atmospherics/pipe/manifold/visible/black{dir = 1},/turf/space,/area/space)
"bD" = (/obj/effect/wallframe_spawn/reinforced,/obj/machinery/door/blast/regular/open{dir = 4; id_tag = "EngineRadiatorViewport"; name = "EngineRadiatorViewport"},/obj/machinery/atmospherics/pipe/simple/visible/blue{dir = 4},/turf/floor/plating,/area/space)
"bE" = (/obj/structure/lattice,/obj/machinery/atmospherics/pipe/simple/heat_exchanging/junction{dir = 4},/turf/space,/area/space)
"bF" = (/obj/structure/lattice,/obj/machinery/atmospherics/pipe/simple/heat_exchanging{dir = 4},/turf/space,/area/space)
"bG" = (/obj/structure/lattice,/obj/machinery/atmospherics/pipe/simple/heat_exchanging{dir = 9},/turf/space,/area/space)
"bH" = (/obj/structure/lattice,/obj/machinery/atmospherics/pipe/simple/heat_exchanging{dir = 5},/turf/space,/area/space)
"bI" = (/obj/machinery/light/small,/turf/floor/plating,/area/space)
"bJ" = (/obj/machinery/alarm{dir = 1; pixel_y = -22},/obj/machinery/atmospherics/unary/vent_pump/on{dir = 4},/turf/floor/plating,/area/space)
"bK" = (/obj/structure/cable{icon_state = "1-2"},/obj/effect/floor_decal/industrial/warning/corner{dir = 4},/obj/machinery/atmospherics/pipe/manifold/hidden/supply{dir = 4},/turf/floor/plating,/area/space)
"bL" = (/obj/machinery/light/small{dir = 4},/obj/effect/floor_decal/industrial/warning{dir = 1},/obj/structure/sign/warning/radioactive{dir = 8; pixel_x = 32},/turf/floor/plating,/area/space)
"bM" = (/obj/structure/sign/warning/radioactive{dir = 4; pixel_x = -32},/turf/floor/plating,/area/space)
"bN" = (/obj/effect/floor_decal/industrial/outline/yellow,/obj/machinery/portable_atmospherics/canister/hydrogen/engine_setup,/turf/floor/plating,/area/space)
"bO" = (/obj/machinery/light,/obj/item/radio/intercom{dir = 1; pixel_y = -30},/obj/effect/floor_decal/industrial/warning,/turf/floor/plating,/area/space)
"bP" = (/obj/effect/floor_decal/industrial/warning,/turf/floor/plating,/area/space)
"bQ" = (/obj/machinery/atmospherics/pipe/simple/visible/yellow{dir = 6},/turf/floor/plating,/area/space)
"bR" = (/obj/machinery/button/blast_door{desc = "A remote control-switch for the engine control room blast doors."; id_tag = "EngineBlast"; name = "Engine Monitoring Room Blast Doors"; pixel_x = 5; pixel_y = -25},/obj/machinery/button/blast_door{desc = "A remote control-switch for the engine charging port."; id_tag = "SupermatterPort"; name = "Reactor Blast Doors"; pixel_x = -5; pixel_y = -25},/obj/machinery/light,/obj/machinery/atmospherics/pipe/simple/visible/yellow{dir = 4},/obj/effect/floor_decal/industrial/warning,/turf/floor/plating,/area/space)
"bS" = (/obj/machinery/atmospherics/pipe/simple/visible/yellow{dir = 10},/turf/floor/plating,/area/space)
"bT" = (/obj/machinery/atmospherics/pipe/simple/visible/cyan,/obj/effect/floor_decal/industrial/warning{dir = 4},/turf/floor/plating,/area/space)
"bU" = (/obj/machinery/atmospherics/binary/circulator{anchored = 1; dir = 1},/turf/floor/plating,/area/space)
"bV" = (/obj/structure/cable/yellow{icon_state = "0-2"},/obj/machinery/generator{anchored = 1; dir = 4},/obj/structure/cable/yellow,/obj/machinery/atmospherics/pipe/simple/visible/green,/turf/floor/plating,/area/space)
"bW" = (/obj/machinery/atmospherics/binary/circulator{anchored = 1},/turf/floor/plating,/area/space)
"bX" = (/obj/effect/floor_decal/industrial/warning{dir = 8},/turf/floor/plating,/area/space)
"bY" = (/obj/effect/floor_decal/industrial/warning{dir = 4},/obj/machinery/atmospherics/pipe/simple/visible/black,/turf/floor/plating,/area/space)
"bZ" = (/obj/effect/wallframe_spawn/reinforced,/obj/machinery/door/blast/regular/open{dir = 4; id_tag = "EngineRadiatorViewport"; name = "EngineRadiatorViewport"},/turf/floor/plating,/area/space)
"ca" = (/obj/structure/lattice,/obj/machinery/atmospherics/pipe/manifold/visible/black{dir = 8},/turf/space,/area/space)
"cb" = (/obj/machinery/atmospherics/pipe/simple/heat_exchanging{dir = 4},/turf/space,/area/space)
"cc" = (/obj/machinery/atmospherics/pipe/simple/heat_exchanging{dir = 4},/obj/structure/lattice,/turf/space,/area/space)
"cd" = (/obj/structure/cable{icon_state = "1-2"},/obj/machinery/door/airlock/maintenance{name = "Engine Waste Handling"},/obj/machinery/atmospherics/pipe/simple/hidden/supply,/turf/floor/tiled/techfloor/grid,/area/space)
"ce" = (/obj/effect/floor_decal/industrial/outline/yellow,/obj/structure/sign/warning/compressed_gas{pixel_y = -32; dir = 1},/obj/machinery/portable_atmospherics/canister/hydrogen/engine_setup,/turf/floor/plating,/area/space)
"cf" = (/obj/machinery/camera/network/engine{c_tag = "Engine Core West"; dir = 8},/turf/floor/plating,/area/space)
"cg" = (/obj/effect/floor_decal/industrial/outline/yellow,/obj/structure/sign/warning/radioactive{pixel_y = -32; dir = 1},/obj/machinery/portable_atmospherics/canister/hydrogen/engine_setup,/turf/floor/plating,/area/space)
"ch" = (/obj/machinery/atmospherics/pipe/simple/visible/cyan,/obj/machinery/door/airlock/hatch,/turf/floor/tiled/techfloor/grid,/area/space)
"ci" = (/obj/machinery/door/blast/regular/open{dir = 2; id_tag = "SupermatterPort"; name = "Reactor Blast Door"},/obj/effect/wallframe_spawn/reinforced_borosilicate,/turf/floor/plating,/area/space)
"cj" = (/obj/machinery/atmospherics/pipe/simple/visible/yellow,/obj/machinery/door/airlock/hatch,/turf/floor/tiled/techfloor/grid,/area/space)
"ck" = (/obj/machinery/atmospherics/pipe/manifold/visible/yellow{dir = 8},/obj/machinery/meter,/obj/machinery/camera/network/engine{c_tag = "Engine Core East"; dir = 4},/obj/effect/floor_decal/industrial/warning{dir = 8},/turf/floor/plating,/area/space)
"cl" = (/obj/machinery/atmospherics/pipe/simple/visible/cyan,/obj/machinery/atmospherics/pipe/simple/visible/yellow{dir = 4},/obj/effect/floor_decal/industrial/warning/corner{dir = 4},/turf/floor/plating,/area/space)
"cm" = (/obj/machinery/atmospherics/pipe/simple/visible/yellow{dir = 9},/obj/effect/floor_decal/industrial/warning{dir = 1},/turf/floor/plating,/area/space)
"cn" = (/obj/structure/cable/yellow{icon_state = "1-2"},/obj/effect/floor_decal/industrial/warning{dir = 1},/obj/machinery/atmospherics/pipe/simple/visible/green,/turf/floor/plating,/area/space)
"co" = (/obj/machinery/atmospherics/pipe/simple/visible/black{dir = 5},/obj/effect/floor_decal/industrial/warning{dir = 1},/turf/floor/plating,/area/space)
"cp" = (/obj/machinery/atmospherics/pipe/simple/visible/black{dir = 4},/obj/effect/floor_decal/industrial/warning/corner{dir = 1},/turf/floor/plating,/area/space)
"cq" = (/obj/machinery/button/blast_door{desc = "A remote control-switch for the engine radiator viewport shutters."; id_tag = "EngineRadiatorViewport"; name = "Engine Radiator Viewport Shutters"; pixel_x = 25; dir = 8},/obj/machinery/atmospherics/pipe/manifold/visible/black{dir = 4},/obj/machinery/meter,/obj/effect/floor_decal/industrial/warning/corner{dir = 4},/turf/floor/plating,/area/space)
"cr" = (/obj/machinery/light/small/red,/obj/machinery/atmospherics/pipe/simple/visible{dir = 5},/turf/floor/reinforced,/area/space)
"cs" = (/obj/machinery/button/blast_door{id_tag = "EngineVent"; name = "Reactor Ventillatory Control"; pixel_x = -25; dir = 4},/obj/structure/window/reinforced,/obj/structure/closet/crate/uranium,/turf/floor/plating,/area/space)
"ct" = (/obj/structure/window/reinforced,/turf/floor/plating,/area/space)
"cu" = (/turf/floor/reinforced,/area/space)
"cv" = (/obj/machinery/air_sensor{id_tag = "engine_sensor"},/turf/floor/reinforced,/area/space)
"cw" = (/obj/machinery/atmospherics/pipe/simple/visible,/turf/floor/reinforced,/area/space)
"cx" = (/obj/machinery/atmospherics/pipe/simple/visible/yellow,/turf/floor/plating,/area/space)
"cy" = (/obj/machinery/atmospherics/pipe/simple/visible/cyan{dir = 5},/obj/effect/floor_decal/industrial/warning/corner,/turf/floor/plating,/area/space)
"cz" = (/obj/structure/cable/yellow{icon_state = "1-2"},/obj/effect/floor_decal/industrial/warning,/obj/machinery/atmospherics/pipe/simple/visible/green{dir = 5},/turf/floor/plating,/area/space)
"cA" = (/obj/effect/floor_decal/industrial/warning,/obj/machinery/atmospherics/pipe/manifold/visible/green{dir = 1},/turf/floor/plating,/area/space)
"cB" = (/obj/machinery/atmospherics/pipe/manifold/visible/black{dir = 8},/turf/space,/area/space)
"cC" = (/obj/machinery/light{dir = 4},/obj/effect/floor_decal/industrial/warning/corner,/obj/machinery/atmospherics/pipe/manifold/visible/black{dir = 4},/turf/floor/plating,/area/space)
"cE" = (/obj/machinery/atmospherics/unary/fission_core,/turf/floor/reinforced,/area/space)
"cF" = (/obj/machinery/atmospherics/pipe/simple/visible,/obj/machinery/meter,/turf/floor/reinforced,/area/space)
"cG" = (/obj/effect/floor_decal/industrial/warning{dir = 4},/turf/floor/plating,/area/space)
"cH" = (/obj/machinery/generator{anchored = 1; dir = 4},/obj/structure/cable/yellow,/turf/floor/plating,/area/space)
"cI" = (/obj/machinery/atmospherics/pipe/simple/heat_exchanging/junction{dir = 4},/obj/structure/lattice,/turf/space,/area/space)
"cJ" = (/obj/machinery/atmospherics/pipe/simple/visible/black,/obj/effect/floor_decal/industrial/warning{dir = 4},/turf/floor/plating,/area/space)
"cK" = (/obj/machinery/atmospherics/pipe/manifold/visible/black,/obj/effect/floor_decal/industrial/warning{dir = 1},/obj/effect/floor_decal/industrial/warning/corner,/turf/floor/plating,/area/space)
"cP" = (/obj/machinery/camera/network/engine{c_tag = "Engine Core South"; dir = 1},/obj/machinery/atmospherics/pipe/simple/visible{dir = 9},/turf/floor/reinforced,/area/space)
"cQ" = (/obj/machinery/atmospherics/pipe/simple/visible/yellow{dir = 5},/turf/floor/plating,/area/space)
"cR" = (/obj/machinery/atmospherics/pipe/simple/visible/yellow{dir = 4},/obj/effect/floor_decal/industrial/warning/corner{dir = 4},/turf/floor/plating,/area/space)
"cS" = (/obj/machinery/atmospherics/pipe/manifold/visible/yellow,/obj/effect/floor_decal/industrial/warning{dir = 1},/turf/floor/plating,/area/space)
"cT" = (/obj/machinery/atmospherics/valve/digital{dir = 4; name = "Emergency Cooling Valve 2"},/obj/effect/floor_decal/industrial/warning{dir = 1},/obj/structure/sign/warning/radioactive{pixel_y = -32; dir = 1},/turf/floor/plating,/area/space)
"cU" = (/obj/machinery/atmospherics/pipe/simple/visible/black{dir = 4},/obj/effect/floor_decal/industrial/warning/corner{dir = 1},/obj/effect/floor_decal/industrial/warning,/turf/floor/plating,/area/space)
"cV" = (/obj/effect/floor_decal/industrial/warning{dir = 6; icon_state = "warning"},/obj/machinery/atmospherics/pipe/manifold/visible/black{dir = 4},/turf/floor/plating,/area/space)
"cW" = (/obj/structure/lattice,/obj/machinery/atmospherics/pipe/simple/visible/black{dir = 5},/turf/space,/area/space)
"cZ" = (/obj/effect/wallframe_spawn/reinforced,/obj/machinery/door/blast/regular/open{dir = 2; id_tag = "EngineRadiatorViewport"; name = "EngineRadiatorViewport"},/turf/floor/plating,/area/space)
"da" = (/obj/effect/wallframe_spawn/reinforced,/obj/machinery/door/blast/regular/open{dir = 2; id_tag = "EngineRadiatorViewport"; name = "EngineRadiatorViewport"},/obj/machinery/atmospherics/pipe/simple/visible/black,/turf/floor/plating,/area/space)
"dc" = (/obj/structure/sign/warning/radioactive{pixel_y = 32},/turf/space,/area/space)
"dd" = (/obj/machinery/atmospherics/pipe/manifold/visible/black,/turf/space,/area/space)
"de" = (/obj/machinery/atmospherics/pipe/simple/visible/black{dir = 4},/turf/space,/area/space)
"df" = (/obj/machinery/atmospherics/pipe/simple/heat_exchanging/junction{dir = 4},/turf/space,/area/space)

(1,1,1) = {"
abababababacababababadabaeaeafaeaeababagabababaaaaaaaaaaaaaaaaaaaaaaaaaaaaaaaaaa
ahaiajakalamabanaoapaqarasatauavawaxayazaAayabaaaaaaaaaaaaaaaaaBaCaBaCaBaCaBaDaa
ahaEaFaGaHaIaJaKaLaMaNaOaPaQaQaQaQaQaRaQaSaTabaaaaaaaaaaaaaaaaaUaUaUaUaUaUaVaUaa
ahaEaWaXaYaZbabbbcbdazazazbebfbgazazbcbhbibjabababaaaaaaaaaaaaaVaVaVaVaVaVaVaUaa
ahbkblbmbnbobpbqbrbsbfbfbfbuazbvbfbfbwbxbybzbAbBbDbCbEbFbFbFbFbGbHbGbHbGbHbGaUaa
abazbIbJbKbLabbMazazazazbOazbPbQbRbSbTbUbVbWbXbYbZcadfcbcbcbcccbcbcbcbcbcbcbbGaa
ababababcdababbtazazazcfabchcicjabckclcmcncocpcqabcBdfcbcbcbcccbcbcbcbcbcbcbaDaa
aaaaaaaaaaaaabcsctazazazabcucvcwabcxcybxczcAbAcCabcacIcccccccccccccccccccccbbGaa
aaaaaaaaaaaaabbNbNazazazabcucEcFabcxcGbUcHbWbXcJbZcacIcccccccccccccccccccccbaDaa
aaaaaaaaaaaaabcecgazazazabcucrcPabcQcRcScTcKcUcVbZcBdfcbcbcbcccbcbcbcbcbcbcbbGaa
aaaaaaaaaaaaababababababababababababababababcZdaabcacIcccccccccccccccccccccbaDaa
aaaaaaaaaaaaaaaaaaaaaaaaaaaaaaaaaaaaaaaadcaaaacWdedddfcbcbcbcccbcbcbcbcbcbcbbGaa
aaaaaaaaaaaaaaaaaaaaaaaaaaaaaaaaaaaaaaaaaaaaaaaaaaaaaaaaaaaaaaaaaaaaaaaaaaaaaaaa
aaaaaaaaaaaaaaaaaaaaaaaaaaaaaaaaaaaaaaaaaaaaaaaaaaaaaaaaaaaaaaaaaaaaaaaaaaaaaaaa
aaaaaaaaaaaaaaaaaaaaaaaaaaaaaaaaaaaaaaaaaaaaaaaaaaaaaaaaaaaaaaaaaaaaaaaaaaaaaaaa
aaaaaaaaaaaaaaaaaaaaaaaaaaaaaaaaaaaaaaaaaaaaaaaaaaaaaaaaaaaaaaaaaaaaaaaaaaaaaaaa
aaaaaaaaaaaaaaaaaaaaaaaaaaaaaaaaaaaaaaaaaaaaaaaaaaaaaaaaaaaaaaaaaaaaaaaaaaaaaaaa
"}
