"aa" = (/turf/space,/area/space)
"ab" = (/turf/wall/r_wall/prepainted,/area/space)
"ac" = (/obj/machinery/door/airlock/maintenance{name = "Drone Fabrication/Engine Waste Handling"},/obj/structure/cable{icon_state = "1-2"},/obj/machinery/atmospherics/pipe/simple/hidden/scrubbers,/obj/machinery/atmospherics/pipe/simple/hidden/supply,/turf/floor/tiled/techfloor/grid,/area/space)
"ad" = (/obj/machinery/door/airlock/hatch{id_tag = "engine_electrical_maintenance"; locked = 1; name = "Electrical Maintenance"},/obj/structure/cable/yellow{icon_state = "1-2"},/turf/floor/plating,/area/space)
"ae" = (/obj/machinery/door/blast/regular/open{dir = 2; id_tag = "EngineBlast"; name = "EngineBlast"},/obj/effect/wallframe_spawn/reinforced,/turf/floor/plating,/area/space)
"af" = (/obj/machinery/door/blast/regular/open{id_tag = "EngineBlast"; name = "Engine Monitoring Room Blast Doors"},/obj/machinery/atmospherics/pipe/simple/hidden/supply,/obj/machinery/atmospherics/pipe/simple/hidden/scrubbers,/obj/effect/wallframe_spawn/reinforced,/turf/floor/plating,/area/space)
"ag" = (/obj/machinery/door/airlock/hatch/maintenance{id_tag = "engine_airlock_interior"; name = "Engine Airlock Interior"},/turf/floor/plating,/area/space)
"ah" = (/obj/machinery/atmospherics/pipe/simple/visible/black{dir = 4},/turf/wall/r_wall/prepainted,/area/space)
"ai" = (/obj/machinery/atmospherics/pipe/simple/visible/black{dir = 10},/turf/floor/plating,/area/space)
"aj" = (/obj/machinery/atmospherics/unary/vent_scrubber/on{dir = 4},/obj/machinery/light/small{dir = 1},/turf/floor/plating,/area/space)
"ak" = (/obj/machinery/power/apc{dir = 1; name = "north bump"; pixel_y = 24},/obj/structure/cable{icon_state = "0-4"},/obj/machinery/atmospherics/pipe/simple/hidden/scrubbers{dir = 4},/turf/floor/plating,/area/space)
"al" = (/obj/structure/cable{icon_state = "2-4"},/obj/structure/cable{icon_state = "4-8"},/obj/machinery/atmospherics/pipe/simple/hidden/scrubbers{dir = 4},/obj/machinery/atmospherics/pipe/simple/hidden/supply{dir = 6},/obj/machinery/camera/network/engine{c_tag = "Engine Waste Handling"},/obj/effect/floor_decal/industrial/warning/corner,/turf/floor/plating,/area/space)
"am" = (/obj/machinery/light/small{dir = 4},/obj/structure/cable{icon_state = "1-8"},/obj/machinery/atmospherics/pipe/simple/hidden/scrubbers{dir = 9},/obj/machinery/atmospherics/pipe/simple/hidden/supply{dir = 9},/obj/effect/floor_decal/industrial/warning,/obj/structure/sign/warning/radioactive{dir = 8; pixel_x = 32},/turf/floor/plating,/area/space)
"an" = (/obj/machinery/button/blast_door{desc = "A remote control-switch for the engine control room blast doors."; id_tag = "EngineEmitterPortWest"; name = "Engine Room Blast Doors"; pixel_y = 25},/obj/machinery/atmospherics/portables_connector{dir = 4},/obj/effect/floor_decal/industrial/outline/yellow,/obj/effect/engine_setup/empty_canister,/obj/structure/sign/warning/radioactive{dir = 4; pixel_x = -32},/turf/floor/plating,/area/space)
"ao" = (/obj/machinery/light{dir = 1},/obj/machinery/atmospherics/binary/pump{dir = 8},/turf/floor/plating,/area/space)
"ap" = (/obj/machinery/atmospherics/pipe/simple/visible/cyan{dir = 10},/obj/machinery/alarm/nobreach{pixel_y = 22},/obj/effect/floor_decal/industrial/warning{dir = 4},/turf/floor/plating,/area/space)
"aq" = (/obj/machinery/power/terminal{dir = 4},/obj/structure/cable/yellow,/obj/machinery/power/sensor{id_tag = "Engine Output"; name = "Powernet Sensor - Engine Output"},/obj/structure/cable/yellow{icon_state = "0-2"},/obj/effect/floor_decal/industrial/warning{dir = 1},/turf/floor/plating,/area/space)
"ar" = (/obj/structure/cable/yellow{icon_state = "0-4"},/obj/machinery/power/smes/buildable{RCon_tag = "Engine - Core"; charge = 5e+006; input_attempt = 1; input_level = 250000; inputting = 1; output_attempt = 1; output_level = 250000},/obj/effect/floor_decal/industrial/warning{dir = 1},/obj/effect/engine_setup/smes,/turf/floor/plating,/area/space)
"as" = (/obj/structure/cable/cyan{icon_state = "4-8"},/obj/effect/floor_decal/industrial/warning{dir = 8},/obj/machinery/fuel_compressor,/turf/floor/plating,/area/space)
"at" = (/obj/structure/cable/cyan{icon_state = "4-8"},/obj/machinery/atmospherics/unary/vent_pump/on{dir = 4},/turf/floor/plating,/area/space)
"au" = (/obj/structure/cable/cyan{icon_state = "4-8"},/obj/machinery/atmospherics/pipe/simple/hidden/supply{dir = 9},/obj/machinery/atmospherics/pipe/simple/hidden/scrubbers{dir = 5},/turf/floor/plating,/area/space)
"av" = (/obj/structure/cable/cyan{icon_state = "4-8"},/obj/machinery/atmospherics/unary/vent_scrubber/on{dir = 8},/turf/floor/plating,/area/space)
"aw" = (/obj/structure/cable/cyan{icon_state = "4-8"},/turf/floor/plating,/area/space)
"ax" = (/obj/machinery/light_switch{pixel_x = 12; pixel_y = 25},/obj/structure/cable/cyan{icon_state = "0-8"},/obj/machinery/power/sensor{id_tag = "Engine Power"; name = "Powernet Sensor - Engine Power"},/obj/machinery/power/apc/super/critical{dir = 1; name = "north bump"; pixel_y = 24},/turf/floor/plating,/area/space)
"ay" = (/obj/machinery/atmospherics/portables_connector,/obj/effect/floor_decal/industrial/outline/blue,/obj/effect/engine_setup/coolant_canister,/turf/floor/plating,/area/space)
"az" = (/turf/floor/plating,/area/space)
"aA" = (/obj/machinery/airlock_sensor{id_tag = "engine_room_airlock"; pixel_y = 22},/obj/machinery/light{dir = 1},/turf/floor/plating,/area/space)
"aB" = (/obj/machinery/atmospherics/pipe/manifold4w/visible/black,/turf/floor/plating,/area/space)
"aC" = (/obj/machinery/atmospherics/binary/pump{dir = 8},/obj/effect/engine_setup/pump_max,/turf/floor/plating,/area/space)
"aD" = (/obj/machinery/atmospherics/portables_connector{dir = 8},/obj/effect/floor_decal/industrial/outline/yellow,/obj/effect/engine_setup/coolant_canister,/turf/floor/plating,/area/space)
"aE" = (/obj/structure/cable{icon_state = "1-2"},/obj/effect/floor_decal/industrial/warning{dir = 4},/obj/machinery/atmospherics/pipe/simple/hidden/supply,/turf/floor/plating,/area/space)
"aF" = (/obj/structure/window/reinforced{dir = 1},/obj/machinery/atmospherics/portables_connector,/obj/machinery/door/window/brigdoor/westleft{name = "Engine Waste"},/obj/effect/floor_decal/industrial/outline/yellow,/obj/effect/engine_setup/empty_canister,/turf/floor/plating,/area/space)
"aG" = (/obj/machinery/door/blast/regular{dir = 8; id_tag = "EngineEmitterPortWest"; name = "Engine Waste Handling Access"},/turf/floor/plating,/area/space)
"aH" = (/obj/machinery/atmospherics/pipe/simple/visible/black{dir = 6},/obj/effect/floor_decal/industrial/warning{dir = 8},/turf/floor/plating,/area/space)
"aI" = (/obj/machinery/atmospherics/omni/filter{tag_east = 1; tag_south = 4; tag_west = 2; use_power = 0},/obj/effect/engine_setup/filter,/turf/floor/plating,/area/space)
"aJ" = (/obj/machinery/atmospherics/pipe/manifold/visible/cyan{dir = 4},/obj/effect/floor_decal/industrial/warning/corner{dir = 4},/turf/floor/plating,/area/space)
"aK" = (/obj/structure/cable/yellow{icon_state = "1-4"},/obj/effect/floor_decal/industrial/warning{dir = 1},/turf/floor/plating,/area/space)
"aL" = (/obj/structure/cable/yellow{icon_state = "4-8"},/obj/effect/floor_decal/industrial/warning{dir = 1},/turf/floor/plating,/area/space)
"aM" = (/obj/structure/cable/yellow{icon_state = "4-8"},/obj/effect/floor_decal/industrial/warning/corner{dir = 1},/turf/floor/plating,/area/space)
"aN" = (/obj/structure/cable/yellow{icon_state = "4-8"},/turf/floor/plating,/area/space)
"aO" = (/obj/machinery/atmospherics/binary/pump,/obj/structure/cable/yellow{icon_state = "4-8"},/obj/effect/engine_setup/pump_max,/turf/floor/plating,/area/space)
"aP" = (/obj/structure/cable/yellow{icon_state = "2-8"},/turf/floor/plating,/area/space)
"aQ" = (/obj/machinery/atmospherics/binary/pump,/obj/effect/engine_setup/pump_max,/turf/floor/plating,/area/space)
"aR" = (/obj/machinery/atmospherics/unary/heat_exchanger{dir = 8},/obj/effect/floor_decal/industrial/warning{dir = 9},/turf/floor/plating,/area/space)
"aS" = (/obj/machinery/atmospherics/unary/heat_exchanger{dir = 4},/obj/effect/floor_decal/industrial/warning{dir = 5},/turf/floor/plating,/area/space)
"aT" = (/obj/structure/cable{icon_state = "1-2"},/obj/machinery/atmospherics/pipe/manifold/visible/black{dir = 1},/obj/effect/floor_decal/industrial/warning{dir = 4},/obj/machinery/atmospherics/pipe/simple/hidden/supply,/turf/floor/plating,/area/space)
"aU" = (/obj/machinery/atmospherics/pipe/simple/visible/black{dir = 9},/obj/machinery/door/window/brigdoor/westleft{name = "Engine Waste"},/obj/effect/floor_decal/industrial/outline/yellow,/turf/floor/plating,/area/space)
"aV" = (/obj/machinery/door/blast/regular{dir = 4; id_tag = "EngineEmitterPortWest"; name = "Engine Waste Handling Access"},/turf/floor/plating,/area/space)
"aW" = (/obj/machinery/atmospherics/pipe/simple/visible/black,/obj/effect/floor_decal/industrial/warning{dir = 8},/turf/floor/plating,/area/space)
"aX" = (/obj/machinery/atmospherics/pipe/manifold/visible/cyan{dir = 8},/turf/floor/plating,/area/space)
"aY" = (/obj/machinery/meter,/obj/machinery/atmospherics/pipe/manifold/visible/cyan{dir = 4},/turf/floor/plating,/area/space)
"aZ" = (/obj/machinery/atmospherics/pipe/simple/visible/cyan{dir = 6},/turf/floor/plating,/area/space)
"ba" = (/obj/machinery/atmospherics/pipe/simple/visible/cyan{dir = 4},/turf/floor/plating,/area/space)
"bb" = (/obj/machinery/atmospherics/pipe/simple/visible/cyan{dir = 10},/turf/floor/plating,/area/space)
"bc" = (/obj/structure/cable/yellow{icon_state = "1-2"},/obj/machinery/atmospherics/pipe/manifold/visible/cyan{dir = 1},/turf/floor/plating,/area/space)
"bd" = (/obj/machinery/atmospherics/pipe/manifold/visible/cyan{dir = 4},/turf/floor/plating,/area/space)
"be" = (/obj/machinery/atmospherics/pipe/manifold/visible/black,/obj/machinery/meter,/turf/floor/plating,/area/space)
"bf" = (/obj/machinery/atmospherics/unary/heat_exchanger{dir = 8},/obj/effect/floor_decal/industrial/warning{dir = 10},/turf/floor/plating,/area/space)
"bg" = (/obj/machinery/atmospherics/unary/heat_exchanger{dir = 4},/obj/effect/floor_decal/industrial/warning{dir = 6},/turf/floor/plating,/area/space)
"bh" = (/obj/structure/cable{icon_state = "1-2"},/obj/machinery/atmospherics/pipe/manifold/visible/black,/obj/machinery/meter{id_tag = "wloop_atm_meter"},/obj/effect/floor_decal/industrial/warning{dir = 4},/obj/machinery/atmospherics/pipe/simple/hidden/supply,/turf/floor/plating,/area/space)
"bi" = (/obj/structure/window/reinforced,/obj/machinery/atmospherics/binary/pump{dir = 8; name = "waste pump"},/obj/machinery/door/window/brigdoor/westleft{name = "Engine Waste"},/obj/effect/floor_decal/industrial/outline/yellow,/obj/effect/engine_setup/pump_max,/turf/floor/plating,/area/space)
"bj" = (/obj/machinery/door/blast/regular{dir = 4; id_tag = "EngineEmitterPortWest"; name = "Engine Waste Handling Access"},/obj/machinery/atmospherics/pipe/simple/visible/black{dir = 4},/turf/floor/plating,/area/space)
"bk" = (/obj/machinery/atmospherics/pipe/manifold/visible/black,/obj/effect/floor_decal/industrial/warning{dir = 8},/turf/floor/plating,/area/space)
"bl" = (/obj/machinery/atmospherics/omni/filter{tag_east = 1; tag_north = 4; tag_west = 2; use_power = 0},/obj/effect/engine_setup/filter,/turf/floor/plating,/area/space)
"bm" = (/obj/machinery/atmospherics/pipe/manifold/visible/cyan,/turf/floor/plating,/area/space)
"bn" = (/obj/machinery/atmospherics/pipe/manifold/visible/cyan{dir = 1},/turf/floor/plating,/area/space)
"bo" = (/obj/machinery/atmospherics/pipe/simple/visible/cyan{dir = 9},/turf/floor/plating,/area/space)
"bp" = (/obj/machinery/atmospherics/pipe/simple/visible/cyan{dir = 5},/turf/floor/plating,/area/space)
"bq" = (/obj/machinery/meter,/obj/machinery/atmospherics/pipe/manifold4w/visible/cyan,/obj/effect/floor_decal/industrial/warning/corner,/turf/floor/plating,/area/space)
"br" = (/obj/machinery/atmospherics/pipe/simple/visible/cyan{dir = 10},/obj/effect/floor_decal/industrial/warning,/turf/floor/plating,/area/space)
"bs" = (/obj/structure/cable/yellow{icon_state = "1-2"},/obj/effect/floor_decal/industrial/warning,/obj/machinery/atmospherics/pipe/simple/visible/cyan,/turf/floor/plating,/area/space)
"bt" = (/obj/machinery/meter,/obj/machinery/atmospherics/pipe/simple/visible/cyan,/turf/floor/plating,/area/space)
"bu" = (/obj/effect/floor_decal/industrial/warning/corner{dir = 8},/turf/floor/plating,/area/space)
"bv" = (/obj/effect/floor_decal/industrial/warning{dir = 4},/turf/floor/plating,/area/space)
"bw" = (/obj/effect/wallframe_spawn/reinforced,/obj/machinery/door/blast/regular/open{dir = 4; id_tag = "EngineRadiatorViewport"; name = "EngineRadiatorViewport"},/obj/machinery/atmospherics/pipe/simple/visible/blue{dir = 4},/turf/floor/plating,/area/space)
"bx" = (/obj/machinery/light/small,/turf/floor/plating,/area/space)
"by" = (/obj/machinery/alarm{dir = 1; pixel_y = -22},/obj/machinery/atmospherics/unary/vent_pump/on{dir = 4},/turf/floor/plating,/area/space)
"bz" = (/obj/structure/cable{icon_state = "1-2"},/obj/effect/floor_decal/industrial/warning/corner{dir = 4},/obj/machinery/atmospherics/pipe/manifold/hidden/supply{dir = 4},/turf/floor/plating,/area/space)
"bA" = (/obj/machinery/light/small{dir = 4},/obj/effect/floor_decal/industrial/warning{dir = 1},/obj/structure/sign/warning/radioactive{dir = 8; pixel_x = 32},/turf/floor/plating,/area/space)
"bB" = (/obj/structure/sign/warning/radioactive{dir = 4; pixel_x = -32},/turf/floor/plating,/area/space)
"bC" = (/obj/machinery/atmospherics/pipe/simple/visible/cyan,/turf/floor/plating,/area/space)
"bD" = (/obj/machinery/light,/obj/item/radio/intercom{dir = 1; pixel_y = -30},/obj/effect/floor_decal/industrial/warning,/turf/floor/plating,/area/space)
"bE" = (/obj/effect/floor_decal/industrial/warning,/turf/floor/plating,/area/space)
"bF" = (/obj/machinery/atmospherics/pipe/simple/visible/yellow{dir = 6},/turf/floor/plating,/area/space)
"bG" = (/obj/machinery/button/blast_door{desc = "A remote control-switch for the engine control room blast doors."; id_tag = "EngineBlast"; name = "Engine Monitoring Room Blast Doors"; pixel_x = 5; pixel_y = -25},/obj/machinery/button/blast_door{desc = "A remote control-switch for the engine charging port."; id_tag = "SupermatterPort"; name = "Reactor Blast Doors"; pixel_x = -5; pixel_y = -25},/obj/machinery/light,/obj/machinery/atmospherics/pipe/simple/visible/yellow{dir = 4},/obj/effect/floor_decal/industrial/warning,/turf/floor/plating,/area/space)
"bH" = (/obj/machinery/atmospherics/pipe/simple/visible/yellow{dir = 10},/turf/floor/plating,/area/space)
"bI" = (/obj/machinery/atmospherics/pipe/simple/visible/cyan,/obj/effect/floor_decal/industrial/warning{dir = 4},/turf/floor/plating,/area/space)
"bJ" = (/obj/machinery/atmospherics/binary/stirling,/obj/structure/cable/yellow{icon_state = "0-4"},/turf/floor/plating,/area/space)
"bK" = (/obj/structure/cable/yellow{icon_state = "0-2"},/obj/structure/cable/yellow,/obj/machinery/atmospherics/binary/stirling,/obj/structure/cable/yellow{icon_state = "1-8"},/obj/structure/cable/yellow{icon_state = "1-4"},/turf/floor/plating,/area/space)
"bL" = (/obj/machinery/atmospherics/binary/stirling,/obj/structure/cable/yellow{icon_state = "0-8"},/turf/floor/plating,/area/space)
"bM" = (/obj/effect/floor_decal/industrial/warning{dir = 8},/turf/floor/plating,/area/space)
"bN" = (/obj/effect/wallframe_spawn/reinforced,/obj/machinery/door/blast/regular/open{dir = 4; id_tag = "EngineRadiatorViewport"; name = "EngineRadiatorViewport"},/turf/floor/plating,/area/space)
"bO" = (/obj/structure/cable{icon_state = "1-2"},/obj/machinery/door/airlock/maintenance{name = "Engine Waste Handling"},/obj/machinery/atmospherics/pipe/simple/hidden/supply,/turf/floor/tiled/techfloor/grid,/area/space)
"bP" = (/obj/machinery/light{dir = 8},/obj/item/tank/stirling,/obj/item/tank/stirling,/obj/item/tank/stirling,/obj/item/tank/stirling,/obj/item/tank/stirling,/obj/item/tank/stirling,/obj/item/tank/stirling,/obj/item/tank/stirling,/obj/item/tank/stirling,/obj/item/tank/stirling,/obj/item/tank/stirling,/obj/item/tank/stirling,/obj/item/tank/stirling,/obj/item/tank/stirling,/obj/structure/closet/crate,/turf/floor/plating,/area/space)
"bQ" = (/obj/machinery/camera/network/engine{c_tag = "Engine Core West"; dir = 8},/turf/floor/plating,/area/space)
"bR" = (/turf/wall/r_titanium,/area/space)
"bS" = (/obj/machinery/door/airlock/hatch,/turf/floor/tiled/techfloor/grid,/area/space)
"bT" = (/obj/machinery/door/blast/regular/open{dir = 2; id_tag = "SupermatterPort"; name = "Reactor Blast Door"},/obj/effect/wallframe_spawn/reinforced_borosilicate,/turf/floor/plating,/area/space)
"bU" = (/obj/machinery/atmospherics/pipe/simple/visible/yellow,/obj/machinery/door/airlock/hatch,/turf/floor/tiled/techfloor/grid,/area/space)
"bV" = (/obj/machinery/atmospherics/pipe/manifold/visible/yellow{dir = 8},/obj/machinery/meter,/obj/machinery/camera/network/engine{c_tag = "Engine Core East"; dir = 4},/obj/effect/floor_decal/industrial/warning{dir = 8},/turf/floor/plating,/area/space)
"bW" = (/obj/machinery/atmospherics/pipe/simple/visible/cyan,/obj/machinery/atmospherics/pipe/simple/visible/yellow{dir = 4},/obj/effect/floor_decal/industrial/warning/corner{dir = 4},/turf/floor/plating,/area/space)
"bX" = (/obj/effect/floor_decal/industrial/warning{dir = 1},/obj/machinery/atmospherics/pipe/manifold/visible/yellow,/turf/floor/plating,/area/space)
"bY" = (/obj/structure/cable/yellow{icon_state = "1-2"},/obj/effect/floor_decal/industrial/warning{dir = 1},/obj/machinery/atmospherics/pipe/manifold/visible/yellow,/turf/floor/plating,/area/space)
"bZ" = (/obj/effect/floor_decal/industrial/warning{dir = 1},/obj/machinery/atmospherics/pipe/simple/visible/yellow{dir = 9},/turf/floor/plating,/area/space)
"ca" = (/obj/machinery/button/blast_door{desc = "A remote control-switch for the engine radiator viewport shutters."; id_tag = "EngineRadiatorViewport"; name = "Engine Radiator Viewport Shutters"; pixel_x = 25; dir = 8},/obj/effect/floor_decal/industrial/warning/corner{dir = 4},/turf/floor/plating,/area/space)
"cb" = (/obj/machinery/button/blast_door{id_tag = "EngineVent"; name = "Reactor Ventillatory Control"; pixel_x = -25; dir = 4},/obj/structure/window/reinforced,/obj/structure/closet/crate/uranium,/turf/floor/plating,/area/space)
"cc" = (/obj/structure/window/reinforced,/turf/floor/plating,/area/space)
"cd" = (/turf/floor/reinforced,/area/space)
"ce" = (/obj/machinery/air_sensor{id_tag = "engine_sensor"},/turf/floor/reinforced,/area/space)
"cf" = (/obj/machinery/atmospherics/pipe/simple/visible,/turf/floor/reinforced,/area/space)
"cg" = (/obj/machinery/atmospherics/pipe/simple/visible/yellow,/turf/floor/plating,/area/space)
"ch" = (/obj/machinery/atmospherics/pipe/simple/visible/cyan{dir = 5},/obj/effect/floor_decal/industrial/warning/corner,/turf/floor/plating,/area/space)
"ci" = (/obj/effect/floor_decal/industrial/warning,/obj/machinery/atmospherics/pipe/manifold/visible/cyan{dir = 1},/turf/floor/plating,/area/space)
"cj" = (/obj/structure/cable/yellow{icon_state = "1-2"},/obj/effect/floor_decal/industrial/warning,/obj/machinery/atmospherics/pipe/manifold/visible/cyan{dir = 1},/turf/floor/plating,/area/space)
"ck" = (/obj/effect/floor_decal/industrial/warning/corner{dir = 8},/obj/machinery/atmospherics/pipe/simple/visible/cyan{dir = 10},/turf/floor/plating,/area/space)
"cl" = (/obj/machinery/light{dir = 4},/obj/effect/floor_decal/industrial/warning/corner,/turf/floor/plating,/area/space)
"cm" = (/obj/effect/floor_decal/industrial/outline/yellow,/obj/machinery/portable_atmospherics/canister/nitrogen,/turf/floor/plating,/area/space)
"cn" = (/obj/machinery/portable_atmospherics/canister/hydrogen/engine_setup,/turf/floor/plating,/area/space)
"co" = (/obj/machinery/atmospherics/unary/fission_core,/turf/floor/reinforced,/area/space)
"cp" = (/obj/machinery/atmospherics/pipe/simple/visible,/obj/machinery/meter,/turf/floor/reinforced,/area/space)
"cq" = (/obj/machinery/atmospherics/binary/stirling,/obj/structure/cable/yellow{icon_state = "1-8"},/obj/structure/cable/yellow{icon_state = "1-4"},/turf/floor/plating,/area/space)
"cr" = (/obj/effect/floor_decal/industrial/warning{dir = 8},/obj/machinery/atmospherics/pipe/simple/visible/cyan,/turf/floor/plating,/area/space)
"cs" = (/obj/effect/floor_decal/industrial/outline/yellow,/obj/machinery/portable_atmospherics/canister/nitrogen,/obj/structure/sign/warning/compressed_gas{pixel_y = -32; dir = 1},/turf/floor/plating,/area/space)
"ct" = (/obj/effect/floor_decal/industrial/outline/yellow,/obj/machinery/portable_atmospherics/canister/nitrogen,/obj/structure/sign/warning/radioactive{pixel_y = -32; dir = 1},/turf/floor/plating,/area/space)
"cu" = (/obj/machinery/light/small/red,/obj/machinery/atmospherics/pipe/simple/visible{dir = 5},/turf/floor/reinforced,/area/space)
"cv" = (/obj/machinery/camera/network/engine{c_tag = "Engine Core South"; dir = 1},/obj/machinery/atmospherics/pipe/simple/visible{dir = 9},/turf/floor/reinforced,/area/space)
"cw" = (/obj/machinery/atmospherics/pipe/simple/visible/yellow{dir = 5},/turf/floor/plating,/area/space)
"cx" = (/obj/machinery/atmospherics/pipe/simple/visible/yellow{dir = 4},/obj/effect/floor_decal/industrial/warning/corner{dir = 4},/turf/floor/plating,/area/space)
"cy" = (/obj/machinery/atmospherics/pipe/manifold/visible/yellow,/obj/effect/floor_decal/industrial/warning{dir = 1},/turf/floor/plating,/area/space)
"cz" = (/obj/effect/floor_decal/industrial/warning{dir = 1},/obj/structure/sign/warning/radioactive{pixel_y = -32; dir = 1},/obj/machinery/atmospherics/pipe/manifold/visible/yellow,/turf/floor/plating,/area/space)
"cA" = (/obj/effect/floor_decal/industrial/warning{dir = 1},/obj/effect/floor_decal/industrial/warning/corner,/obj/machinery/light,/obj/machinery/atmospherics/pipe/simple/visible/yellow{dir = 9},/turf/floor/plating,/area/space)
"cB" = (/obj/effect/floor_decal/industrial/warning/corner{dir = 1},/obj/effect/floor_decal/industrial/warning,/obj/machinery/atmospherics/pipe/simple/visible/cyan,/turf/floor/plating,/area/space)
"cC" = (/obj/effect/floor_decal/industrial/warning{dir = 6; icon_state = "warning"},/turf/floor/plating,/area/space)
"cD" = (/obj/machinery/atmospherics/pipe/simple/heat_exchanging/junction,/turf/wall/r_wall/prepainted,/area/space)
"cE" = (/obj/effect/wallframe_spawn/reinforced,/obj/machinery/door/blast/regular/open{dir = 2; id_tag = "EngineRadiatorViewport"; name = "EngineRadiatorViewport"},/obj/machinery/atmospherics/pipe/simple/heat_exchanging/junction,/turf/floor/plating,/area/space)
"cF" = (/obj/effect/wallframe_spawn/reinforced,/obj/machinery/door/blast/regular/open{dir = 2; id_tag = "EngineRadiatorViewport"; name = "EngineRadiatorViewport"},/obj/machinery/atmospherics/pipe/simple/visible/black,/turf/floor/plating,/area/space)
"cG" = (/obj/machinery/atmospherics/pipe/simple/heat_exchanging{dir = 6},/turf/space,/area/space)
"cH" = (/obj/machinery/atmospherics/pipe/simple/heat_exchanging{dir = 4},/turf/space,/area/space)
"cI" = (/obj/machinery/atmospherics/pipe/simple/heat_exchanging{dir = 9},/turf/space,/area/space)
"cJ" = (/obj/machinery/atmospherics/pipe/simple/heat_exchanging{dir = 10},/turf/space,/area/space)
"cK" = (/obj/machinery/atmospherics/pipe/simple/heat_exchanging{dir = 5},/turf/space,/area/space)
"cL" = (/obj/machinery/atmospherics/pipe/simple/heat_exchanging,/turf/space,/area/space)

(1,1,1) = {"
abababababacababababadabaeaeafaeaeababagabababaaaaaaaaaaaaaaaaaaaaaaaaaaaaaaaaaa
ahaiajakalamabanaoapaqarasatauavawaxayazaAayabaaaaaaaaaaaaaaaaaaaaaaaaaaaaaaaaaa
ahaBaCaDaEaFaGaHaIaJaKaLaMaNaNaNaNaNaOaNaPaQabaaaaaaaaaaaaaaaaaaaaaaaaaaaaaaaaaa
ahaBaRaSaTaUaVaWaXaYazazazaZbabbazazaXbabcbdababababaaaaaaaaaaaaaaaaaaaaaaaaaaaa
ahbebfbgbhbibjbkblbmbnbababoazbpbababqbrbsbtbuazbvbwaaaaaaaaaaaaaaaaaaaaaaaaaaaa
abazbxbybzbAabbBazazbCazbDazbEbFbGbHbIbJbKbLbMazbvbNaaaaaaaaaaaaaaaaaaaaaaaaaaaa
ababababbOababbPazazbCbQbRbSbTbUbRbVbWbXbYbZazazcaabaaaaaaaaaaaaaaaaaaaaaaaaaaaa
aaaaaaaaaaaaabcbccazbCazbRcdcecfbRcgchcicjcickazclabaaaaaaaaaaaaaaaaaaaaaaaaaaaa
aaaaaaaaaaaaabcmcmazbCcnbRcdcocpbRcgbvbJcqbLcrazbvbNaaaaaaaaaaaaaaaaaaaaaaaaaaaa
aaaaaaaaaaaaabcsctazbCcnbRcdcucvbRcwcxcyczcAcBazcCbNaaaaaaaaaaaaaaaaaaaaaaaaaaaa
aaaaaaaaaaaaababababcDabbRbRbRbRbRabababababcEcFababaaaaaaaaaaaaaaaaaaaaaaaaaaaa
cGcHcHcHcHcHcHcHcHcHcIcGcJcGcJcGcJcGcJcGcJcGcIaaaaaaaaaaaaaaaaaaaaaaaaaaaaaaaaaa
cKcHcHcHcHcHcHcHcHcHcJcLcLcLcLcLcLcLcLcLcLcLaaaaaaaaaaaaaaaaaaaaaaaaaaaaaaaaaaaa
cGcHcHcHcHcHcHcHcHcHcIcLcLcLcLcLcLcLcLcLcLcLaaaaaaaaaaaaaaaaaaaaaaaaaaaaaaaaaaaa
cKcHcHcHcHcHcHcHcHcHcJcLcLcLcLcLcLcLcLcLcLcLaaaaaaaaaaaaaaaaaaaaaaaaaaaaaaaaaaaa
cGcHcHcHcHcHcHcHcHcHcIcLcLcLcLcLcLcLcLcLcLcLaaaaaaaaaaaaaaaaaaaaaaaaaaaaaaaaaaaa
cKcHcHcHcHcHcHcHcHcHcHcIcKcIcKcIcKcIcKcIcKcIaaaaaaaaaaaaaaaaaaaaaaaaaaaaaaaaaaaa
"}
